-wv-v---
-wv-v-hh
-w------
-w-v-v-v
-w-v-v-v
-ww-wwww
--------