wwwwwwww
w-b-b-b-
w-b-b-b-
w-------
w-------
www--www
--------
--------