-wb-b--b
-wb-b--b
-w------
-w-b-b-b
-w-b-b-b
-w------
-ww-wwww
--------